NO ./images/mc_old_nether_rack.xpm
SO ./images/mc_nether_brick.xpm
WE ./images/mc_old_nether_brick.xpm
EA ./images/mc_nether_rack.xpm

C 7,128,198
F 16,107,4

1111111111111111111111111111111111
1000000000000000000000000000011111
100000000000000000000000000000001111
1000000100000000000000000000000000001
10000000000000000000000000000000000001
10000000000000000000000000000000000001
1000N000000000000000000000000000001111
100000000000000000000000000000000000001
100000000000000000000000000000000001111
100000000000000000000000000000000000001
1111111111111111111111111111111111111111111
